DDDDDDDD
D.....CD
DRD.E.DD
DEB..DGD
D..D.D.D
D.DD...D
DP.....D
DDDDDDDD